Songs and Search
	Song Library	blog/music4dance-help/song-list/
	Song Details	blog/music4dance-help/song-details/
	Add Songs	blog/music4dance-help/add-songs/
	Simple Search	blog/music4dance-help/simple-search/
	Advanced Search	blog/music4dance-help/advanced-search/
	Saved Searched	blog/music4dance-help/saved-searches/
Dances
	Dance Styles	blog/music4dance-help/dance-styles-help/
	Dance Categories	blog/music4dance-help/dance-category/
	Dance Details	blog/music4dance-help/dance-details/
	Dance Tags	blog/music4dance-help/dance-tags/
Tags
	Tag Cloud	blog/music4dance-help/tag-cloud/
	Tag Definition	blog/music4dance-help/tag-definitions/
	Tag Filtering	blog/music4dance-help/tag-filtering/
	Tag Editing	blog/music4dance-help/tag-editing/
Tools
	Tempo Counter	blog/music4dance-help/tempo-counter/
	Dance Tempi	blog/music4dance-help/dance-tempi/
Account Management	blog/music4dance-help/account-management/
Subscriptions	/blog/music4dance-help/subscriptions
	Bonus Content	/blog/music4dance-help/bonus-content/
Playing or Purchasing Songs	blog/music4dance-help/playing-or-purchasing-songs/
	ITunes	blog/music4dance-help/playing-or-purchasing-songs/itunes/
	Amazon	blog/music4dance-help/playing-or-purchasing-songs/amazon/
	Spotify	blog/music4dance-help/playing-or-purchasing-songs/spotify/
	Groove	blog/music4dance-help/playing-or-purchasing-songs/groove/
	EchoNest	blog/music4dance-help/playing-or-purchasing-songs/echonest/
Beta	blog/music4dance-help/beta/
Feedback	blog/feedback/
Bug Report	blog/bug-report
